5 13 31
###############################
#p * *1       *  ** * *      *#
# # # # #*# # #*# # # # # #*# #
#    * * *** **  2   *    **  #
# #*# # # # #4# #b#1# # # # #*#
#          *     **      *  **#
# # #*# # # # # #*#*#*#*# # # #
#   *        *   * *x* *   1  #
# # # # #*# # # # # # #*# #*# #
# 3 ****         *2      4    #
# # # # # # # # # #*# # # # #*#
#  ** *1  *    2              #
###############################