2 13 31
###############################
#p * *2       *  ** * *  3   *#
# # # # #*# # #*# # # # # #*# #
#    * * *** **      *    **  #
# #*# # # # #1# #b#1# # # # #*#
#   b      *     **      *  **#
# # #*# # # # # #*#*#*#*# # # #
#   *        *   * *x* *      #
# # # # #*# # # # # # #*# #*# #
#   **s*         *1           #
# # # # # # # # # #*# # # # #*#
#  ** *   *    4              #
###############################